FontDame GSUB table


script table begin
marc	default		0, 1, 2
script table end


feature table begin
0	abvs	13
1	calt	0, 1, 2, 3, 4, 6, 7, 5, 8, 9
2	pres	11

feature table end

lookup	0	ligature

RightToLeft	no
IgnoreBaseGlyphs	no
IgnoreLigatures	no
IgnoreMarks	no

da_ma.sub	da_marc	ma_marc.sub
da_ha.sub	da_marc	ha_marc.sub
ra_ka.sub	ra_marc	ka_marc.sub
ra_ga.sub	ra_marc	ga_marc.sub
ra_nga.sub	ra_marc	nga_marc.sub
ra_ja.sub	ra_marc	ja_marc.sub
ra_nya.sub	ra_marc	nya_marc.sub
ra_ta.sub	ra_marc	ta_marc.sub
ra_da.sub	ra_marc	da_marc.sub
ra_na.sub	ra_marc	na_marc.sub
ra_ba.sub	ra_marc	ba_marc.sub
ra_ma.sub	ra_marc	ma_marc.sub
ra_tsa.sub	ra_marc	tsa_marc.sub
ra_dza.sub	ra_marc	dza_marc.sub
la_ka.sub	la_marc	ka_marc.sub
la_ga.sub	la_marc	ga_marc.sub
la_nga.sub	la_marc	nga_marc.sub
la_ca.sub	la_marc	ca_marc.sub
la_ja.sub	la_marc	ja_marc.sub
la_ta.sub	la_marc	ta_marc.sub
la_da.sub	la_marc	da_marc.sub
la_pa.sub	la_marc	pa_marc.sub
la_ba.sub	la_marc	ba_marc.sub
la_ha.sub	la_marc	ha_marc.sub
sa_ka.sub	sa_marc	ka_marc.sub
sa_ga.sub	sa_marc	ga_marc.sub
sa_nga.sub	sa_marc	nga_marc.sub
sa_nya.sub	sa_marc	nya_marc.sub
sa_ta.sub	sa_marc	ta_marc.sub
sa_da.sub	sa_marc	da_marc.sub
sa_na.sub	sa_marc	na_marc.sub
sa_pa.sub	sa_marc	pa_marc.sub
sa_ba.sub	sa_marc	ba_marc.sub
sa_ma.sub	sa_marc	ma_marc.sub
sa_tsa.sub	sa_marc	tsa_marc.sub

lookup end


lookup	1	ligature

RightToLeft	no
IgnoreBaseGlyphs	no
IgnoreLigatures	no
IgnoreMarks	no

ka_wa.sub_i_marc	i_marc	ka_marc	wa_marc.sub
ka_ra.sub_i_marc	i_marc	ka_marc	ra_marc.sub
ka_la.sub_i_marc	i_marc	ka_marc	la_marc.sub
ka_ya.sub_i_marc	i_marc	ka_marc	ya_marc.sub
ka_i_marc	i_marc	ka_marc
kha_wa.sub_i_marc	i_marc	kha_marc	wa_marc.sub
kha_ra.sub_i_marc	i_marc	kha_marc	ra_marc.sub
kha_ya.sub_i_marc	i_marc	kha_marc	ya_marc.sub
kha_i_marc	i_marc	kha_marc
ga_wa.sub_i_marc	i_marc	ga_marc	wa_marc.sub
ga_ra.sub_i_marc	i_marc	ga_marc	ra_marc.sub
ga_la.sub_i_marc	i_marc	ga_marc	la_marc.sub
ga_ya.sub_i_marc	i_marc	ga_marc	ya_marc.sub
ga_i_marc	i_marc	ga_marc
nga_i_marc	i_marc	nga_marc
ca_wa.sub_i_marc	i_marc	ca_marc	wa_marc.sub
ca_i_marc	i_marc	ca_marc
cha_i_marc	i_marc	cha_marc
ja_i_marc	i_marc	ja_marc
nya_wa.sub_i_marc	i_marc	nya_marc	wa_marc.sub
nya_i_marc	i_marc	nya_marc
ta_wa.sub_i_marc	i_marc	ta_marc	wa_marc.sub
ta_ra.sub_i_marc	i_marc	ta_marc	ra_marc.sub
ta_i_marc	i_marc	ta_marc
tha_ra.sub_i_marc	i_marc	tha_marc	ra_marc.sub
tha_i_marc	i_marc	tha_marc
da_wa.sub_i_marc	i_marc	da_marc	wa_marc.sub
da_ra.sub_i_marc	i_marc	da_marc	ra_marc.sub
da_i_marc	i_marc	da_marc
na_i_marc	i_marc	na_marc
pa_ra.sub_i_marc	i_marc	pa_marc	ra_marc.sub
pa_ya.sub_i_marc	i_marc	pa_marc	ya_marc.sub
pa_i_marc	i_marc	pa_marc
pha_ra.sub_i_marc	i_marc	pha_marc	ra_marc.sub
pha_ya.sub_i_marc	i_marc	pha_marc	ya_marc.sub
pha_i_marc	i_marc	pha_marc
ba_ra.sub_i_marc	i_marc	ba_marc	ra_marc.sub
ba_la.sub_i_marc	i_marc	ba_marc	la_marc.sub
ba_ya.sub_i_marc	i_marc	ba_marc	ya_marc.sub
ba_i_marc	i_marc	ba_marc
ma_ra.sub_i_marc	i_marc	ma_marc	ra_marc.sub
ma_ya.sub_i_marc	i_marc	ma_marc	ya_marc.sub
ma_i_marc	i_marc	ma_marc
tsa_wa.sub_i_marc	i_marc	tsa_marc	wa_marc.sub
tsa_i_marc	i_marc	tsa_marc
tsha_wa.sub_i_marc	i_marc	tsha_marc	wa_marc.sub
tsha_i_marc	i_marc	tsha_marc
dza_i_marc	i_marc	dza_marc
wa_i_marc	i_marc	wa_marc
zha_wa.sub_i_marc	i_marc	zha_marc	wa_marc.sub
zha_i_marc	i_marc	zha_marc
za_wa.sub_i_marc	i_marc	za_marc	wa_marc.sub
za_la.sub_i_marc	i_marc	za_marc	la_marc.sub
za_i_marc	i_marc	za_marc
aa_i_marc	i_marc	aa_marc
ya_i_marc	i_marc	ya_marc
ra_wa.sub_i_marc	i_marc	ra_marc	wa_marc.sub
ra_la.sub_i_marc	i_marc	ra_marc	la_marc.sub
ra_i_marc	i_marc	ra_marc
la_wa.sub_i_marc	i_marc	la_marc	wa_marc.sub
la_i_marc	i_marc	la_marc
sha_wa.sub_i_marc	i_marc	sha_marc	wa_marc.sub
sha_ra.sub_i_marc	i_marc	sha_marc	ra_marc.sub
sha_i_marc	i_marc	sha_marc
sa_wa.sub_i_marc	i_marc	sa_marc	wa_marc.sub
sa_ra.sub_i_marc	i_marc	sa_marc	ra_marc.sub
sa_la.sub_i_marc	i_marc	sa_marc	la_marc.sub
sa_i_marc	i_marc	sa_marc
ha_wa.sub_i_marc	i_marc	ha_marc	wa_marc.sub
ha_ra.sub_aa_i_marc	i_marc	ha_marc	ra_marc.sub	aa_marc.sub
ha_ra.sub_i_marc	i_marc	ha_marc	ra_marc.sub
ha_i_marc	i_marc	ha_marc
a_i_marc	i_marc	a_marc
da_ha.sub_aa.sub_i_marc	i_marc	da_ha.sub	aa_marc.sub
da_ha.sub_i_marc	i_marc	da_ha.sub
la_ba.sub_i_marc	i_marc	la_ba.sub
la_ca.sub_i_marc	i_marc	la_ca.sub
la_da.sub_i_marc	i_marc	la_da.sub
la_ga.sub_ya.sub_i_marc	i_marc	la_ga.sub	ya_marc.sub
la_ga.sub_i_marc	i_marc	la_ga.sub
la_ha.sub_i_marc	i_marc	la_ha.sub
la_ja.sub_i_marc	i_marc	la_ja.sub
la_ka.sub_i_marc	i_marc	la_ka.sub
la_nga.sub_i_marc	i_marc	la_nga.sub
la_pa.sub_i_marc	i_marc	la_pa.sub
la_ta.sub_i_marc	i_marc	la_ta.sub
ra_ba.sub_i_marc	i_marc	ra_ba.sub
ra_da.sub_ra.sub_i_marc	i_marc	ra_da.sub	ra_marc.sub
ra_da.sub_i_marc	i_marc	ra_da.sub
ra_dza.sub_i_marc	i_marc	ra_dza.sub
ra_ga.sub_ya.sub_i_marc	i_marc	ra_ga.sub	ya_marc.sub
ra_ga.sub_i_marc	i_marc	ra_ga.sub
ra_ja.sub_i_marc	i_marc	ra_ja.sub
ra_ka.sub_ya.sub_i_marc	i_marc	ra_ka.sub	ya_marc.sub
ra_ka.sub_i_marc	i_marc	ra_ka.sub
ra_ma.sub_ya.sub_i_marc	i_marc	ra_ma.sub	ya_marc.sub
ra_ma.sub_i_marc	i_marc	ra_ma.sub
ra_na.sub_i_marc	i_marc	ra_na.sub
ra_nga.sub_i_marc	i_marc	ra_nga.sub
ra_nya.sub_i_marc	i_marc	ra_nya.sub
ra_ta.sub_i_marc	i_marc	ra_ta.sub
ra_tsa.sub_wa.sub_i_marc	i_marc	ra_tsa.sub	wa_marc.sub
ra_tsa.sub_i_marc	i_marc	ra_tsa.sub
sa_ba.sub_ra.sub_i_marc	i_marc	sa_ba.sub	ra_marc.sub
sa_ba.sub_ya.sub_i_marc	i_marc	sa_ba.sub	ya_marc.sub
sa_ba.sub_i_marc	i_marc	sa_ba.sub
sa_da.sub_i_marc	i_marc	sa_da.sub
sa_ga.sub_ra.sub_i_marc	i_marc	sa_ga.sub	ra_marc.sub
sa_ga.sub_ya.sub_i_marc	i_marc	sa_ga.sub	ya_marc.sub
sa_ga.sub_i_marc	i_marc	sa_ga.sub
sa_ka.sub_ra.sub_i_marc	i_marc	sa_ka.sub	ra_marc.sub
sa_ka.sub_ya.sub_i_marc	i_marc	sa_ka.sub	ya_marc.sub
sa_ka.sub_i_marc	i_marc	sa_ka.sub
sa_ma.sub_ra.sub_i_marc	i_marc	sa_ma.sub	ra_marc.sub
sa_ma.sub_ya.sub_i_marc	i_marc	sa_ma.sub	ya_marc.sub
sa_ma.sub_i_marc	i_marc	sa_ma.sub
sa_na.sub_ra.sub_i_marc	i_marc	sa_na.sub	ra_marc.sub
sa_na.sub_i_marc	i_marc	sa_na.sub
sa_nga.sub_i_marc	i_marc	sa_nga.sub
sa_nya.sub_i_marc	i_marc	sa_nya.sub
sa_pa.sub_ra.sub_i_marc	i_marc	sa_pa.sub	ra_marc.sub
sa_pa.sub_ya.sub_i_marc	i_marc	sa_pa.sub	ya_marc.sub
sa_pa.sub_i_marc	i_marc	sa_pa.sub
sa_ta.sub_wa.sub_i_marc	i_marc	sa_ta.sub	wa_marc.sub
sa_ta.sub_ra.sub_i_marc	i_marc	sa_ta.sub	ra_marc.sub
sa_ta.sub_i_marc	i_marc	sa_ta.sub
sa_tsa.sub_i_marc	i_marc	sa_tsa.sub

lookup end


lookup	2	ligature

RightToLeft	no
IgnoreBaseGlyphs	no
IgnoreLigatures	no
IgnoreMarks	no

ka_e_marc	ka_marc	e_marc
ka_wa.sub_e_marc	ka_marc	wa_marc.sub	e_marc
ka_ra.sub_e_marc	ka_marc	ra_marc.sub	e_marc
ka_la.sub_e_marc	ka_marc	la_marc.sub	e_marc
ka_ya.sub_e_marc	ka_marc	ya_marc.sub	e_marc
kha_e_marc	kha_marc	e_marc
kha_wa.sub_e_marc	kha_marc	wa_marc.sub	e_marc
kha_ra.sub_e_marc	kha_marc	ra_marc.sub	e_marc
kha_ya.sub_e_marc	kha_marc	ya_marc.sub	e_marc
ga_e_marc	ga_marc	e_marc
ga_wa.sub_e_marc	ga_marc	wa_marc.sub	e_marc
ga_ra.sub_e_marc	ga_marc	ra_marc.sub	e_marc
ga_la.sub_e_marc	ga_marc	la_marc.sub	e_marc
ga_ya.sub_e_marc	ga_marc	ya_marc.sub	e_marc
nga_e_marc	nga_marc	e_marc
ca_e_marc	ca_marc	e_marc
ca_wa.sub_e_marc	ca_marc	wa_marc.sub	e_marc
cha_e_marc	cha_marc	e_marc
ja_e_marc	ja_marc	e_marc
nya_e_marc	nya_marc	e_marc
nya_wa.sub_e_marc	nya_marc	wa_marc.sub	e_marc
ta_e_marc	ta_marc	e_marc
ta_wa.sub_e_marc	ta_marc	wa_marc.sub	e_marc
ta_ra.sub_e_marc	ta_marc	ra_marc.sub	e_marc
tha_e_marc	tha_marc	e_marc
tha_ra.sub_e_marc	tha_marc	ra_marc.sub	e_marc
da_e_marc	da_marc	e_marc
da_wa.sub_e_marc	da_marc	wa_marc.sub	e_marc
da_ra.sub_e_marc	da_marc	ra_marc.sub	e_marc
na_e_marc	na_marc	e_marc
pa_e_marc	pa_marc	e_marc
pa_ra.sub_e_marc	pa_marc	ra_marc.sub	e_marc
pa_ya.sub_e_marc	pa_marc	ya_marc.sub	e_marc
pha_e_marc	pha_marc	e_marc
pha_ra.sub_e_marc	pha_marc	ra_marc.sub	e_marc
pha_ya.sub_e_marc	pha_marc	ya_marc.sub	e_marc
ba_e_marc	ba_marc	e_marc
ba_ra.sub_e_marc	ba_marc	ra_marc.sub	e_marc
ba_la.sub_e_marc	ba_marc	la_marc.sub	e_marc
ba_ya.sub_e_marc	ba_marc	ya_marc.sub	e_marc
ma_e_marc	ma_marc	e_marc
ma_ra.sub_e_marc	ma_marc	ra_marc.sub	e_marc
ma_ya.sub_e_marc	ma_marc	ya_marc.sub	e_marc
tsa_e_marc	tsa_marc	e_marc
tsa_wa.sub_e_marc	tsa_marc	wa_marc.sub	e_marc
tsha_e_marc	tsha_marc	e_marc
tsha_wa.sub_e_marc	tsha_marc	wa_marc.sub	e_marc
dza_e_marc	dza_marc	e_marc
dza_ra.sub_e_marc	dza_marc	ra_marc.sub	e_marc
wa_e_marc	wa_marc	e_marc
zha_e_marc	zha_marc	e_marc
zha_wa.sub_e_marc	zha_marc	wa_marc.sub	e_marc
za_e_marc	za_marc	e_marc
za_wa.sub_e_marc	za_marc	wa_marc.sub	e_marc
za_la.sub_e_marc	za_marc	la_marc.sub	e_marc
ya_e_marc	ya_marc	e_marc
ra_e_marc	ra_marc	e_marc
ra_wa.sub_e_marc	ra_marc	wa_marc.sub	e_marc
ra_la.sub_e_marc	ra_marc	la_marc.sub	e_marc
la_e_marc	la_marc	e_marc
la_wa.sub_e_marc	la_marc	wa_marc.sub	e_marc
sha_e_marc	sha_marc	e_marc
sha_wa.sub_e_marc	sha_marc	wa_marc.sub	e_marc
sha_ra.sub_e_marc	sha_marc	ra_marc.sub	e_marc
sa_e_marc	sa_marc	e_marc
sa_wa.sub_e_marc	sa_marc	wa_marc.sub	e_marc
sa_ra.sub_e_marc	sa_marc	ra_marc.sub	e_marc
sa_la.sub_e_marc	sa_marc	la_marc.sub	e_marc
ha_e_marc	ha_marc	e_marc
ha_wa.sub_e_marc	ha_marc	wa_marc.sub	e_marc
ha_ra.sub_e_marc	ha_marc	ra_marc.sub	e_marc
a_e_marc	a_marc	e_marc
da_ma.sub_e_marc	da_ma.sub	e_marc
la_ba.sub_e_marc	la_ba.sub	e_marc
la_ca.sub_e_marc	la_ca.sub	e_marc
la_da.sub_e_marc	la_da.sub	e_marc
la_ga.sub_e_marc	la_ga.sub	e_marc
la_ga.sub_ya.sub_e_marc	la_ga.sub	ya_marc.sub	e_marc
la_ha.sub_e_marc	la_ha.sub	e_marc
la_ja.sub_e_marc	la_ja.sub	e_marc
la_ka.sub_e_marc	la_ka.sub	e_marc
la_nga.sub_e_marc	la_nga.sub	e_marc
la_pa.sub_e_marc	la_pa.sub	e_marc
la_ta.sub_e_marc	la_ta.sub	e_marc
ra_ba.sub_e_marc	ra_ba.sub	e_marc
ra_da.sub_e_marc	ra_da.sub	e_marc
ra_da.sub_ra.sub_e_marc	ra_da.sub	ra_marc.sub	e_marc
ra_dza.sub_e_marc	ra_dza.sub	e_marc
ra_ga.sub_e_marc	ra_ga.sub	e_marc
ra_ga.sub_ya.sub_e_marc	ra_ga.sub	ya_marc.sub	e_marc
ra_ja.sub_e_marc	ra_ja.sub	e_marc
ra_ka.sub_e_marc	ra_ka.sub	e_marc
ra_ka.sub_ya.sub_e_marc	ra_ka.sub	ya_marc.sub	e_marc
ra_ma.sub_e_marc	ra_ma.sub	e_marc
ra_ma.sub_ya.sub_e_marc	ra_ma.sub	ya_marc.sub	e_marc
ra_na.sub_e_marc	ra_na.sub	e_marc
ra_nga.sub_e_marc	ra_nga.sub	e_marc
ra_nya.sub_e_marc	ra_nya.sub	e_marc
ra_ta.sub_e_marc	ra_ta.sub	e_marc
ra_tsa.sub_e_marc	ra_tsa.sub	e_marc
ra_tsa.sub_wa.sub_e_marc	ra_tsa.sub	wa_marc.sub	e_marc
sa_ba.sub_e_marc	sa_ba.sub	e_marc
sa_ba.sub_ra.sub_e_marc	sa_ba.sub	ra_marc.sub	e_marc
sa_ba.sub_ya.sub_e_marc	sa_ba.sub	ya_marc.sub	e_marc
sa_da.sub_e_marc	sa_da.sub	e_marc
sa_ga.sub_e_marc	sa_ga.sub	e_marc
sa_ga.sub_ra.sub_e_marc	sa_ga.sub	ra_marc.sub	e_marc
sa_ga.sub_ya.sub_e_marc	sa_ga.sub	ya_marc.sub	e_marc
sa_ka.sub_e_marc	sa_ka.sub	e_marc
sa_ka.sub_ra.sub_e_marc	sa_ka.sub	ra_marc.sub	e_marc
sa_ka.sub_ya.sub_e_marc	sa_ka.sub	ya_marc.sub	e_marc
sa_ma.sub_e_marc	sa_ma.sub	e_marc
sa_ma.sub_ra.sub_e_marc	sa_ma.sub	ra_marc.sub	e_marc
sa_ma.sub_ya.sub_e_marc	sa_ma.sub	ya_marc.sub	e_marc
sa_na.sub_e_marc	sa_na.sub	e_marc
sa_na.sub_ra.sub_e_marc	sa_na.sub	ra_marc.sub	e_marc
sa_nga.sub_e_marc	sa_nga.sub	e_marc
sa_nya.sub_e_marc	sa_nya.sub	e_marc
sa_pa.sub_e_marc	sa_pa.sub	e_marc
sa_pa.sub_ra.sub_e_marc	sa_pa.sub	ra_marc.sub	e_marc
sa_pa.sub_ya.sub_e_marc	sa_pa.sub	ya_marc.sub	e_marc
sa_ta.sub_e_marc	sa_ta.sub	e_marc
sa_ta.sub_wa.sub_e_marc	sa_ta.sub	wa_marc.sub	e_marc
sa_ta.sub_ra.sub_e_marc	sa_ta.sub	ra_marc.sub	e_marc
sa_tsa.sub_e_marc	sa_tsa.sub	e_marc

lookup end


lookup	3	ligature

RightToLeft	no
IgnoreBaseGlyphs	no
IgnoreLigatures	no
IgnoreMarks	no

ka_o_marc	ka_marc	o_marc
ka_wa.sub_o_marc	ka_marc	wa_marc.sub	o_marc
ka_ra.sub_o_marc	ka_marc	ra_marc.sub	o_marc
ka_la.sub_o_marc	ka_marc	la_marc.sub	o_marc
ka_ya.sub_o_marc	ka_marc	ya_marc.sub	o_marc
kha_o_marc	kha_marc	o_marc
kha_wa.sub_o_marc	kha_marc	wa_marc.sub	o_marc
kha_ra.sub_o_marc	kha_marc	ra_marc.sub	o_marc
kha_ya.sub_o_marc	kha_marc	ya_marc.sub	o_marc
ga_o_marc	ga_marc	o_marc
ga_wa.sub_o_marc	ga_marc	wa_marc.sub	o_marc
ga_ra.sub_o_marc	ga_marc	ra_marc.sub	o_marc
ga_la.sub_o_marc	ga_marc	la_marc.sub	o_marc
ga_ya.sub_o_marc	ga_marc	ya_marc.sub	o_marc
nga_o_marc	nga_marc	o_marc
ca_o_marc	ca_marc	o_marc
ca_wa.sub_o_marc	ca_marc	wa_marc.sub	o_marc
cha_o_marc	cha_marc	o_marc
ja_o_marc	ja_marc	o_marc
nya_o_marc	nya_marc	o_marc
nya_wa.sub_o_marc	nya_marc	wa_marc.sub	o_marc
ta_o_marc	ta_marc	o_marc
ta_wa.sub_o_marc	ta_marc	wa_marc.sub	o_marc
ta_ra.sub_o_marc	ta_marc	ra_marc.sub	o_marc
tha_o_marc	tha_marc	o_marc
tha_ra.sub_o_marc	tha_marc	ra_marc.sub	o_marc
da_o_marc	da_marc	o_marc
da_wa.sub_o_marc	da_marc	wa_marc.sub	o_marc
da_ra.sub_o_marc	da_marc	ra_marc.sub	o_marc
na_o_marc	na_marc	o_marc
pa_o_marc	pa_marc	o_marc
pa_ra.sub_o_marc	pa_marc	ra_marc.sub	o_marc
pa_ya.sub_o_marc	pa_marc	ya_marc.sub	o_marc
pha_o_marc	pha_marc	o_marc
pha_ra.sub_o_marc	pha_marc	ra_marc.sub	o_marc
pha_ya.sub_o_marc	pha_marc	ya_marc.sub	o_marc
ba_o_marc	ba_marc	o_marc
ba_ra.sub_o_marc	ba_marc	ra_marc.sub	o_marc
ba_la.sub_o_marc	ba_marc	la_marc.sub	o_marc
ba_ya.sub_o_marc	ba_marc	ya_marc.sub	o_marc
ma_o_marc	ma_marc	o_marc
ma_ra.sub_o_marc	ma_marc	ra_marc.sub	o_marc
ma_ya.sub_o_marc	ma_marc	ya_marc.sub	o_marc
tsa_o_marc	tsa_marc	o_marc
tsa_wa.sub_o_marc	tsa_marc	wa_marc.sub	o_marc
tsha_o_marc	tsha_marc	o_marc
tsha_wa.sub_o_marc	tsha_marc	wa_marc.sub	o_marc
dza_o_marc	dza_marc	o_marc
wa_o_marc	wa_marc	o_marc
zha_o_marc	zha_marc	o_marc
zha_wa.sub_o_marc	zha_marc	wa_marc.sub	o_marc
za_o_marc	za_marc	o_marc
za_wa.sub_o_marc	za_marc	wa_marc.sub	o_marc
za_la.sub_o_marc	za_marc	la_marc.sub	o_marc
aa_o_marc	aa_marc	o_marc
ya_o_marc	ya_marc	o_marc
ra_o_marc	ra_marc	o_marc
ra_wa.sub_o_marc	ra_marc	wa_marc.sub	o_marc
ra_la.sub_o_marc	ra_marc	la_marc.sub	o_marc
la_o_marc	la_marc	o_marc
la_wa.sub_o_marc	la_marc	wa_marc.sub	o_marc
sha_o_marc	sha_marc	o_marc
sha_wa.sub_o_marc	sha_marc	wa_marc.sub	o_marc
sha_ra.sub_o_marc	sha_marc	ra_marc.sub	o_marc
sa_o_marc	sa_marc	o_marc
sa_wa.sub_o_marc	sa_marc	wa_marc.sub	o_marc
sa_ra.sub_o_marc	sa_marc	ra_marc.sub	o_marc
sa_la.sub_o_marc	sa_marc	la_marc.sub	o_marc
ha_o_marc	ha_marc	o_marc
ha_wa.sub_o_marc	ha_marc	wa_marc.sub	o_marc
ha_ra.sub_o_marc	ha_marc	ra_marc.sub	o_marc
a_o_marc	a_marc	o_marc
a_aa_o_marc	a_marc	aa_marc.sub	o_marc
la_ba.sub_o_marc	la_ba.sub	o_marc
la_ca.sub_o_marc	la_ca.sub	o_marc
la_da.sub_o_marc	la_da.sub	o_marc
la_ga.sub_o_marc	la_ga.sub	o_marc
la_ga.sub_ya.sub_o_marc	la_ga.sub	ya_marc.sub	o_marc
la_ha.sub_o_marc	la_ha.sub	o_marc
la_ja.sub_o_marc	la_ja.sub	o_marc
la_ka.sub_o_marc	la_ka.sub	o_marc
la_nga.sub_o_marc	la_nga.sub	o_marc
la_pa.sub_o_marc	la_pa.sub	o_marc
la_ta.sub_o_marc	la_ta.sub	o_marc
ra_ba.sub_o_marc	ra_ba.sub	o_marc
ra_da.sub_o_marc	ra_da.sub	o_marc
ra_da.sub_ra.sub_o_marc	ra_da.sub	ra_marc.sub	o_marc
ra_dza.sub_o_marc	ra_dza.sub	o_marc
ra_ga.sub_o_marc	ra_ga.sub	o_marc
ra_ga.sub_ya.sub_o_marc	ra_ga.sub	ya_marc.sub	o_marc
ra_ja.sub_o_marc	ra_ja.sub	o_marc
ra_ka.sub_o_marc	ra_ka.sub	o_marc
ra_ka.sub_ya.sub_o_marc	ra_ka.sub	ya_marc.sub	o_marc
ra_ma.sub_o_marc	ra_ma.sub	o_marc
ra_ma.sub_ya.sub_o_marc	ra_ma.sub	ya_marc.sub	o_marc
ra_na.sub_o_marc	ra_na.sub	o_marc
ra_nga.sub_o_marc	ra_nga.sub	o_marc
ra_nya.sub_o_marc	ra_nya.sub	o_marc
ra_ta.sub_o_marc	ra_ta.sub	o_marc
ra_tsa.sub_o_marc	ra_tsa.sub	o_marc
ra_tsa.sub_wa.sub_o_marc	ra_tsa.sub	wa_marc.sub	o_marc
sa_ba.sub_o_marc	sa_ba.sub	o_marc
sa_ba.sub_ra.sub_o_marc	sa_ba.sub	ra_marc.sub	o_marc
sa_ba.sub_ya.sub_o_marc	sa_ba.sub	ya_marc.sub	o_marc
sa_da.sub_o_marc	sa_da.sub	o_marc
sa_ga.sub_o_marc	sa_ga.sub	o_marc
sa_ga.sub_ra.sub_o_marc	sa_ga.sub	ra_marc.sub	o_marc
sa_ga.sub_ya.sub_o_marc	sa_ga.sub	ya_marc.sub	o_marc
sa_ka.sub_o_marc	sa_ka.sub	o_marc
sa_ka.sub_ra.sub_o_marc	sa_ka.sub	ra_marc.sub	o_marc
sa_ka.sub_ya.sub_o_marc	sa_ka.sub	ya_marc.sub	o_marc
sa_ma.sub_o_marc	sa_ma.sub	o_marc
sa_ma.sub_ra.sub_o_marc	sa_ma.sub	ra_marc.sub	o_marc
sa_ma.sub_ya.sub_o_marc	sa_ma.sub	ya_marc.sub	o_marc
sa_na.sub_o_marc	sa_na.sub	o_marc
sa_na.sub_ra.sub_o_marc	sa_na.sub	ra_marc.sub	o_marc
sa_nga.sub_o_marc	sa_nga.sub	o_marc
sa_nya.sub_o_marc	sa_nya.sub	o_marc
sa_pa.sub_o_marc	sa_pa.sub	o_marc
sa_pa.sub_ra.sub_o_marc	sa_pa.sub	ra_marc.sub	o_marc
sa_pa.sub_ya.sub_o_marc	sa_pa.sub	ya_marc.sub	o_marc
sa_ta.sub_o_marc	sa_ta.sub	o_marc
sa_ta.sub_wa.sub_o_marc	sa_ta.sub	wa_marc.sub	o_marc
sa_ta.sub_ra.sub_o_marc	sa_ta.sub	ra_marc.sub	o_marc
sa_tsa.sub_o_marc	sa_tsa.sub	o_marc

lookup end


lookup	4	ligature

RightToLeft	no
IgnoreBaseGlyphs	no
IgnoreLigatures	no
IgnoreMarks	no

ka_u_marc	ka_marc	u_marc
ka_wa.sub_u_marc	ka_marc	wa_marc.sub	u_marc
ka_ra.sub_u_marc	ka_marc	ra_marc.sub	u_marc
ka_la.sub_u_marc	ka_marc	la_marc.sub	u_marc
ka_ya.sub_u_marc	ka_marc	ya_marc.sub	u_marc
kha_u_marc	kha_marc	u_marc
kha_wa.sub_u_marc	kha_marc	wa_marc.sub	u_marc
kha_ra.sub_u_marc	kha_marc	ra_marc.sub	u_marc
kha_ya.sub_u_marc	kha_marc	ya_marc.sub	u_marc
ga_u_marc	ga_marc	u_marc
ga_wa.sub_u_marc	ga_marc	wa_marc.sub	u_marc
ga_ra.sub_u_marc	ga_marc	ra_marc.sub	u_marc
ga_la.sub_u_marc	ga_marc	la_marc.sub	u_marc
ga_ya.sub_u_marc	ga_marc	ya_marc.sub	u_marc
nga_u_marc	nga_marc	u_marc
ca_u_marc	ca_marc	u_marc
ca_wa.sub_u_marc	ca_marc	wa_marc.sub	u_marc
cha_u_marc	cha_marc	u_marc
ja_u_marc	ja_marc	u_marc
nya_u_marc	nya_marc	u_marc
nya_wa.sub_u_marc	nya_marc	wa_marc.sub	u_marc
ta_u_marc	ta_marc	u_marc
ta_wa.sub_u_marc	ta_marc	wa_marc.sub	u_marc
ta_ra.sub_u_marc	ta_marc	ra_marc.sub	u_marc
tha_u_marc	tha_marc	u_marc
tha_ra.sub_u_marc	tha_marc	ra_marc.sub	u_marc
da_u_marc	da_marc	u_marc
da_wa.sub_u_marc	da_marc	wa_marc.sub	u_marc
da_ra.sub_u_marc	da_marc	ra_marc.sub	u_marc
na_u_marc	na_marc	u_marc
pa_u_marc	pa_marc	u_marc
pa_ra.sub_u_marc	pa_marc	ra_marc.sub	u_marc
pa_ya.sub_u_marc	pa_marc	ya_marc.sub	u_marc
pha_u_marc	pha_marc	u_marc
pha_ra.sub_u_marc	pha_marc	ra_marc.sub	u_marc
pha_ya.sub_u_marc	pha_marc	ya_marc.sub	u_marc
ba_u_marc	ba_marc	u_marc
ba_ra.sub_u_marc	ba_marc	ra_marc.sub	u_marc
ba_la.sub_u_marc	ba_marc	la_marc.sub	u_marc
ba_ya.sub_u_marc	ba_marc	ya_marc.sub	u_marc
ma_u_marc	ma_marc	u_marc
ma_ra.sub_u_marc	ma_marc	ra_marc.sub	u_marc
ma_ya.sub_u_marc	ma_marc	ya_marc.sub	u_marc
tsa_u_marc	tsa_marc	u_marc
tsa_wa.sub_u_marc	tsa_marc	wa_marc.sub	u_marc
tsha_u_marc	tsha_marc	u_marc
tsha_wa.sub_u_marc	tsha_marc	wa_marc.sub	u_marc
dza_u_marc	dza_marc	u_marc
wa_u_marc	wa_marc	u_marc
zha_u_marc	zha_marc	u_marc
zha_wa.sub_u_marc	zha_marc	wa_marc.sub	u_marc
za_u_marc	za_marc	u_marc
za_wa.sub_u_marc	za_marc	wa_marc.sub	u_marc
za_la.sub_u_marc	za_marc	la_marc.sub	u_marc
aa_u_marc	aa_marc	u_marc
ya_u_marc	ya_marc	u_marc
ra_u_marc	ra_marc	u_marc
ra_wa.sub_u_marc	ra_marc	wa_marc.sub	u_marc
ra_la.sub_u_marc	ra_marc	la_marc.sub	u_marc
la_u_marc	la_marc	u_marc
la_wa.sub_u_marc	la_marc	wa_marc.sub	u_marc
sha_u_marc	sha_marc	u_marc
sha_wa.sub_u_marc	sha_marc	wa_marc.sub	u_marc
sha_ra.sub_u_marc	sha_marc	ra_marc.sub	u_marc
sa_u_marc	sa_marc	u_marc
sa_wa.sub_u_marc	sa_marc	wa_marc.sub	u_marc
sa_ra.sub_u_marc	sa_marc	ra_marc.sub	u_marc
sa_la.sub_u_marc	sa_marc	la_marc.sub	u_marc
ha_u_marc	ha_marc	u_marc
ha_wa.sub_u_marc	ha_marc	wa_marc.sub	u_marc
ha_aa_u_marc	ha_marc	aa_marc.sub	u_marc
ha_ra.sub_u_marc	ha_marc	ra_marc.sub	u_marc
a_u_marc	a_marc	u_marc
la_ba.sub_u_marc	la_ba.sub	u_marc
la_ca.sub_u_marc	la_ca.sub	u_marc
la_da.sub_u_marc	la_da.sub	u_marc
la_ga.sub_u_marc	la_ga.sub	u_marc
la_ga.sub_ya.sub_u_marc	la_ga.sub	ya_marc.sub	u_marc
la_ha.sub_u_marc	la_ha.sub	u_marc
la_ja.sub_u_marc	la_ja.sub	u_marc
la_ka.sub_u_marc	la_ka.sub	u_marc
la_nga.sub_u_marc	la_nga.sub	u_marc
la_pa.sub_u_marc	la_pa.sub	u_marc
la_ta.sub_u_marc	la_ta.sub	u_marc
ra_ba.sub_u_marc	ra_ba.sub	u_marc
ra_da.sub_u_marc	ra_da.sub	u_marc
ra_da.sub_ra.sub_u_marc	ra_da.sub	ra_marc.sub	u_marc
ra_dza.sub_u_marc	ra_dza.sub	u_marc
ra_ga.sub_u_marc	ra_ga.sub	u_marc
ra_ga.sub_ya.sub_u_marc	ra_ga.sub	ya_marc.sub	u_marc
ra_ja.sub_u_marc	ra_ja.sub	u_marc
ra_ka.sub_u_marc	ra_ka.sub	u_marc
ra_ka.sub_ya.sub_u_marc	ra_ka.sub	ya_marc.sub	u_marc
ra_ma.sub_u_marc	ra_ma.sub	u_marc
ra_ma.sub_ya.sub_u_marc	ra_ma.sub	ya_marc.sub	u_marc
ra_na.sub_u_marc	ra_na.sub	u_marc
ra_nga.sub_u_marc	ra_nga.sub	u_marc
ra_nya.sub_u_marc	ra_nya.sub	u_marc
ra_ta.sub_u_marc	ra_ta.sub	u_marc
ra_tsa.sub_u_marc	ra_tsa.sub	u_marc
ra_tsa.sub_wa.sub_u_marc	ra_tsa.sub	wa_marc.sub	u_marc
sa_ba.sub_u_marc	sa_ba.sub	u_marc
sa_ba.sub_ra.sub_u_marc	sa_ba.sub	ra_marc.sub	u_marc
sa_ba.sub_ya.sub_u_marc	sa_ba.sub	ya_marc.sub	u_marc
sa_da.sub_u_marc	sa_da.sub	u_marc
sa_ga.sub_u_marc	sa_ga.sub	u_marc
sa_ga.sub_ra.sub_u_marc	sa_ga.sub	ra_marc.sub	u_marc
sa_ga.sub_ya.sub_u_marc	sa_ga.sub	ya_marc.sub	u_marc
sa_ka.sub_u_marc	sa_ka.sub	u_marc
sa_ka.sub_ra.sub_u_marc	sa_ka.sub	ra_marc.sub	u_marc
sa_ka.sub_ya.sub_u_marc	sa_ka.sub	ya_marc.sub	u_marc
sa_ma.sub_u_marc	sa_ma.sub	u_marc
sa_ma.sub_ra.sub_u_marc	sa_ma.sub	ra_marc.sub	u_marc
sa_ma.sub_ya.sub_u_marc	sa_ma.sub	ya_marc.sub	u_marc
sa_na.sub_u_marc	sa_na.sub	u_marc
sa_na.sub_ra.sub_u_marc	sa_na.sub	ra_marc.sub	u_marc
sa_nga.sub_u_marc	sa_nga.sub	u_marc
sa_nya.sub_u_marc	sa_nya.sub	u_marc
sa_pa.sub_u_marc	sa_pa.sub	u_marc
sa_pa.sub_ra.sub_u_marc	sa_pa.sub	ra_marc.sub	u_marc
sa_pa.sub_ya.sub_u_marc	sa_pa.sub	ya_marc.sub	u_marc
sa_ta.sub_u_marc	sa_ta.sub	u_marc
sa_ta.sub_wa.sub_u_marc	sa_ta.sub	wa_marc.sub	u_marc
sa_ta.sub_ra.sub_u_marc	sa_ta.sub	ra_marc.sub	u_marc
sa_tsa.sub_u_marc	sa_tsa.sub	u_marc

lookup end


lookup	5	ligature

RightToLeft	no
IgnoreBaseGlyphs	no
IgnoreLigatures	no
IgnoreMarks	no

ka_la.sub	ka_marc	la_marc.sub
ga_la.sub	ga_marc	la_marc.sub
ba_la.sub	ba_marc	la_marc.sub
za_la.sub	za_marc	la_marc.sub
ra_la.sub	ra_marc	la_marc.sub
sa_la.sub	sa_marc	la_marc.sub

lookup end


lookup	6	ligature

RightToLeft	no
IgnoreBaseGlyphs	no
IgnoreLigatures	no
IgnoreMarks	no

ka_ra.sub	ka_marc	ra_marc.sub
kha_ra.sub	kha_marc	ra_marc.sub
ga_ra.sub	ga_marc	ra_marc.sub
nga_ra.sub	nga_marc	ra_marc.sub
ca_ra.sub	ca_marc	ra_marc.sub
nya_ra.sub	nya_marc	ra_marc.sub
ta_ra.sub	ta_marc	ra_marc.sub
tha_ra.sub	tha_marc	ra_marc.sub
da_ra.sub	da_marc	ra_marc.sub
na_ra.sub	na_marc	ra_marc.sub
pa_ra.sub	pa_marc	ra_marc.sub
pha_ra.sub	pha_marc	ra_marc.sub
ba_ra.sub	ba_marc	ra_marc.sub
ma_ra.sub	ma_marc	ra_marc.sub
tsa_ra.sub	tsa_marc	ra_marc.sub
tsha_ra.sub	tsha_marc	ra_marc.sub
dza_ra.sub	dza_marc	ra_marc.sub
wa_ra.sub	wa_marc	ra_marc.sub
zha_ra.sub	zha_marc	ra_marc.sub
ya_ra.sub	ya_marc	ra_marc.sub
ra_ra.sub	ra_marc	ra_marc.sub
la_ra.sub	la_marc	ra_marc.sub
sha_ra.sub	sha_marc	ra_marc.sub
sa_tha.sub_ra.sub	sa_marc	tha_marc.sub	ra_marc.sub
sa_ra.sub	sa_marc	ra_marc.sub
ha_ra.sub	ha_marc	ra_marc.sub
a_ra.sub	a_marc	ra_marc.sub
ra_da.sub_ra.sub	ra_da.sub	ra_marc.sub
sa_ba.sub_ra.sub	sa_ba.sub	ra_marc.sub
sa_ga.sub_ra.sub	sa_ga.sub	ra_marc.sub
sa_ka.sub_ra.sub	sa_ka.sub	ra_marc.sub
sa_ma.sub_ra.sub	sa_ma.sub	ra_marc.sub
sa_na.sub_ra.sub	sa_na.sub	ra_marc.sub
sa_pa.sub_ra.sub	sa_pa.sub	ra_marc.sub
sa_ta.sub_ra.sub	sa_ta.sub	ra_marc.sub

lookup end


lookup	7	ligature

RightToLeft	no
IgnoreBaseGlyphs	no
IgnoreLigatures	no
IgnoreMarks	no

ka_ya.sub	ka_marc	ya_marc.sub
kha_ya.sub	kha_marc	ya_marc.sub
ga_ya.sub	ga_marc	ya_marc.sub
da_ya.sub	da_marc	ya_marc.sub
pa_ya.sub	pa_marc	ya_marc.sub
pha_ya.sub	pha_marc	ya_marc.sub
ba_ya.sub	ba_marc	ya_marc.sub
ma_ya.sub	ma_marc	ya_marc.sub
la_ga.sub_ya.sub	la_ga.sub	ya_marc.sub
ra_ga.sub_ya.sub	ra_ga.sub	ya_marc.sub
ra_ka.sub_ya.sub	ra_ka.sub	ya_marc.sub
ra_ma.sub_ya.sub	ra_ma.sub	ya_marc.sub
sa_ba.sub_ya.sub	sa_ba.sub	ya_marc.sub
sa_ga.sub_ya.sub	sa_ga.sub	ya_marc.sub
sa_ka.sub_ya.sub	sa_ka.sub	ya_marc.sub
sa_ma.sub_ya.sub	sa_ma.sub	ya_marc.sub
sa_pa.sub_ya.sub	sa_pa.sub	ya_marc.sub

lookup end


lookup	8	ligature

RightToLeft	no
IgnoreBaseGlyphs	no
IgnoreLigatures	no
IgnoreMarks	no

ka_wa.sub	ka_marc	wa_marc.sub
kha_wa.sub	kha_marc	wa_marc.sub
ga_wa.sub	ga_marc	wa_marc.sub
ca_wa.sub	ca_marc	wa_marc.sub
nya_wa.sub	nya_marc	wa_marc.sub
ta_wa.sub	ta_marc	wa_marc.sub
da_wa.sub	da_marc	wa_marc.sub
na_wa.sub	na_marc	wa_marc.sub
pa_wa.sub	pa_marc	wa_marc.sub
ma_wa.sub	ma_marc	wa_marc.sub
tsa_wa.sub	tsa_marc	wa_marc.sub
tsha_wa.sub	tsha_marc	wa_marc.sub
dza_wa.sub	dza_marc	wa_marc.sub
zha_wa.sub	zha_marc	wa_marc.sub
za_wa.sub	za_marc	wa_marc.sub
ra_wa.sub	ra_marc	wa_marc.sub
la_wa.sub	la_marc	wa_marc.sub
sha_wa.sub	sha_marc	wa_marc.sub
sa_wa.sub	sa_marc	wa_marc.sub
ha_wa.sub	ha_marc	wa_marc.sub
da_ra.sub_wa.sub	da_ra.sub	wa_marc.sub
ga_ra.sub_wa.sub	ga_ra.sub	wa_marc.sub
ra_tsa.sub_wa.sub	ra_tsa.sub	wa_marc.sub
sa_ta.sub_wa.sub	sa_ta.sub	wa_marc.sub

lookup end


lookup	9	ligature

RightToLeft	no
IgnoreBaseGlyphs	no
IgnoreLigatures	no
IgnoreMarks	no

ka_aa_marc.sub	ka_marc	aa_marc.sub
kha_aa_marc.sub	kha_marc	aa_marc.sub
ga_aa_marc.sub	ga_marc	aa_marc.sub
nga_aa_marc.sub	nga_marc	aa_marc.sub
ca_aa_marc.sub	ca_marc	aa_marc.sub
cha_aa_marc.sub	cha_marc	aa_marc.sub
ja_aa_marc.sub	ja_marc	aa_marc.sub
nya_aa_marc.sub	nya_marc	aa_marc.sub
ta_aa_marc.sub	ta_marc	aa_marc.sub
tha_aa_marc.sub	tha_marc	aa_marc.sub
da_aa_marc.sub	da_marc	aa_marc.sub
na_aa_marc.sub	na_marc	aa_marc.sub
pa_aa_marc.sub	pa_marc	aa_marc.sub
pha_aa_marc.sub	pha_marc	aa_marc.sub
ba_aa_marc.sub	ba_marc	aa_marc.sub
ma_aa_marc.sub	ma_marc	aa_marc.sub
tsa_aa_marc.sub	tsa_marc	aa_marc.sub
tsha_aa_marc.sub	tsha_marc	aa_marc.sub
dza_aa_marc.sub	dza_marc	aa_marc.sub
wa_aa_marc.sub	wa_marc	aa_marc.sub
zha_aa_marc.sub	zha_marc	aa_marc.sub
za_aa_marc.sub	za_marc	aa_marc.sub
ya_aa_marc.sub	ya_marc	aa_marc.sub
ra_aa_marc.sub	ra_marc	aa_marc.sub
la_aa_marc.sub	la_marc	aa_marc.sub
sha_aa_marc.sub	sha_marc	aa_marc.sub
sa_aa_marc.sub	sa_marc	aa_marc.sub
ha_aa_marc.sub	ha_marc	aa_marc.sub
a_aa_marc.sub	a_marc	aa_marc.sub

lookup end


lookup	10	single

RightToLeft	no
IgnoreBaseGlyphs	no
IgnoreLigatures	no
IgnoreMarks	no

ba_la.sub_i_marc	ba_la.sub_i_marc_short
ga_la.sub_i_marc	ga_la.sub_i_marc_short
ka_la.sub_i_marc	ka_la.sub_i_marc_short
la_ga.sub_ya.sub_i_marc	la_ga.sub_ya.sub_i_marc_short
ra_da.sub_ra.sub_i_marc	ra_da.sub_ra.sub_i_marc_short
ra_ga.sub_ya.sub_i_marc	ra_ga.sub_ya.sub_i_marc_short
ra_ka.sub_ya.sub_i_marc	ra_ka.sub_ya.sub_i_marc_short
ra_la.sub_i_marc	ra_la.sub_i_marc_short
ra_ma.sub_ya.sub_i_marc	ra_ma.sub_ya.sub_i_marc_short
ra_tsa.sub_wa.sub_i_marc	ra_tsa.sub_wa.sub_i_marc_short
sa_ba.sub_ra.sub_i_marc	sa_ba.sub_ra.sub_i_marc_short
sa_ba.sub_ya.sub_i_marc	sa_ba.sub_ya.sub_i_marc_short
sa_ga.sub_ra.sub_i_marc	sa_ga.sub_ra.sub_i_marc_short
sa_ga.sub_ya.sub_i_marc	sa_ga.sub_ya.sub_i_marc_short
sa_ka.sub_ra.sub_i_marc	sa_ka.sub_ra.sub_i_marc_short
sa_ka.sub_ya.sub_i_marc	sa_ka.sub_ya.sub_i_marc_short
sa_la.sub_i_marc	sa_la.sub_i_marc_short
sa_ma.sub_ra.sub_i_marc	sa_ma.sub_ra.sub_i_marc_short
sa_ma.sub_ya.sub_i_marc	sa_ma.sub_ya.sub_i_marc_short
sa_na.sub_ra.sub_i_marc	sa_na.sub_ra.sub_i_marc_short
sa_pa.sub_ra.sub_i_marc	sa_pa.sub_ra.sub_i_marc_short
sa_pa.sub_ya.sub_i_marc	sa_pa.sub_ya.sub_i_marc_short
sa_ta.sub_ra.sub_i_marc	sa_ta.sub_ra.sub_i_marc_short
sa_ta.sub_wa.sub_i_marc	sa_ta.sub_wa.sub_i_marc_short
za_la.sub_i_marc	za_la.sub_i_marc_short

lookup end


lookup	11	chained

RightToLeft	no
IgnoreBaseGlyphs	no
IgnoreLigatures	no
IgnoreMarks	no

backtrackcoverage definition begin
ga_marc
da_marc
ba_marc
ma_marc
aa_marc
coverage definition end

inputcoverage definition begin
ba_la.sub_i_marc
ga_la.sub_i_marc
ka_la.sub_i_marc
la_ga.sub_ya.sub_i_marc
ra_da.sub_ra.sub_i_marc
ra_ga.sub_ya.sub_i_marc
ra_ka.sub_ya.sub_i_marc
ra_la.sub_i_marc
ra_ma.sub_ya.sub_i_marc
ra_tsa.sub_wa.sub_i_marc
sa_ba.sub_ra.sub_i_marc
sa_ba.sub_ya.sub_i_marc
sa_ga.sub_ra.sub_i_marc
sa_ga.sub_ya.sub_i_marc
sa_ka.sub_ra.sub_i_marc
sa_ka.sub_ya.sub_i_marc
sa_la.sub_i_marc
sa_ma.sub_ra.sub_i_marc
sa_ma.sub_ya.sub_i_marc
sa_na.sub_ra.sub_i_marc
sa_pa.sub_ra.sub_i_marc
sa_pa.sub_ya.sub_i_marc
sa_ta.sub_ra.sub_i_marc
sa_ta.sub_wa.sub_i_marc
za_la.sub_i_marc
coverage definition end

coverage	1,10
lookup end


lookup	12	single

RightToLeft	no
IgnoreBaseGlyphs	no
IgnoreLigatures	no
IgnoreMarks	no

candrabindu_marc	candrabindu_marc.narrow

lookup end


lookup	13	chained

RightToLeft	no
IgnoreBaseGlyphs	no
IgnoreLigatures	no
IgnoreMarks	no

backtrackcoverage definition begin
a_i_marc
aa_i_marc
ba_i_marc
ba_la.sub_i_marc
ba_la.sub_i_marc_short
ba_ra.sub_i_marc
ba_ya.sub_i_marc
ca_i_marc
ca_wa.sub_i_marc
cha_i_marc
da_ha.sub_aa.sub_i_marc
da_ha.sub_i_marc
da_i_marc
da_ra.sub_i_marc
da_wa.sub_i_marc
dza_i_marc
ga_i_marc
ga_la.sub_i_marc
ga_la.sub_i_marc_short
ga_ra.sub_i_marc
ga_wa.sub_i_marc
ga_ya.sub_i_marc
ha_i_marc
ha_ra.sub_aa_i_marc
ha_ra.sub_i_marc
ha_wa.sub_i_marc
ja_i_marc
ka_i_marc
ka_la.sub_i_marc
ka_la.sub_i_marc_short
ka_ra.sub_i_marc
ka_wa.sub_i_marc
ka_ya.sub_i_marc
kha_i_marc
kha_ra.sub_i_marc
kha_wa.sub_i_marc
kha_ya.sub_i_marc
la_ba.sub_i_marc
la_ca.sub_i_marc
la_da.sub_i_marc
la_ga.sub_i_marc
la_ga.sub_ya.sub_i_marc
la_ga.sub_ya.sub_i_marc_short
la_ha.sub_i_marc
la_i_marc
la_ja.sub_i_marc
la_ka.sub_i_marc
la_nga.sub_i_marc
la_pa.sub_i_marc
la_ta.sub_i_marc
la_wa.sub_i_marc
ma_i_marc
ma_ra.sub_i_marc
ma_ya.sub_i_marc
na_i_marc
nga_i_marc
nya_i_marc
nya_wa.sub_i_marc
pa_i_marc
pa_ra.sub_i_marc
pa_ya.sub_i_marc
pha_i_marc
pha_ra.sub_i_marc
pha_ya.sub_i_marc
ra_ba.sub_i_marc
ra_da.sub_i_marc
ra_da.sub_ra.sub_i_marc
ra_da.sub_ra.sub_i_marc_short
ra_dza.sub_i_marc
ra_ga.sub_i_marc
ra_ga.sub_ya.sub_i_marc
ra_ga.sub_ya.sub_i_marc_short
ra_i_marc
ra_ja.sub_i_marc
ra_ka.sub_i_marc
ra_ka.sub_ya.sub_i_marc
ra_ka.sub_ya.sub_i_marc_short
ra_la.sub_i_marc
ra_la.sub_i_marc_short
ra_ma.sub_i_marc
ra_ma.sub_ya.sub_i_marc
ra_ma.sub_ya.sub_i_marc_short
ra_na.sub_i_marc
ra_nga.sub_i_marc
ra_nya.sub_i_marc
ra_ta.sub_i_marc
ra_tsa.sub_i_marc
ra_tsa.sub_wa.sub_i_marc
ra_tsa.sub_wa.sub_i_marc_short
ra_wa.sub_i_marc
sa_ba.sub_i_marc
sa_ba.sub_ra.sub_i_marc
sa_ba.sub_ra.sub_i_marc_short
sa_ba.sub_ya.sub_i_marc
sa_ba.sub_ya.sub_i_marc_short
sa_da.sub_i_marc
sa_ga.sub_i_marc
sa_ga.sub_ra.sub_i_marc
sa_ga.sub_ra.sub_i_marc_short
sa_ga.sub_ya.sub_i_marc
sa_ga.sub_ya.sub_i_marc_short
sa_i_marc
sa_ka.sub_i_marc
sa_ka.sub_ra.sub_i_marc
sa_ka.sub_ra.sub_i_marc_short
sa_ka.sub_ya.sub_i_marc
sa_ka.sub_ya.sub_i_marc_short
sa_la.sub_i_marc
sa_la.sub_i_marc_short
sa_ma.sub_i_marc
sa_ma.sub_ra.sub_i_marc
sa_ma.sub_ra.sub_i_marc_short
sa_ma.sub_ya.sub_i_marc
sa_ma.sub_ya.sub_i_marc_short
sa_na.sub_i_marc
sa_na.sub_ra.sub_i_marc
sa_na.sub_ra.sub_i_marc_short
sa_nga.sub_i_marc
sa_nya.sub_i_marc
sa_pa.sub_i_marc
sa_pa.sub_ra.sub_i_marc
sa_pa.sub_ra.sub_i_marc_short
sa_pa.sub_ya.sub_i_marc
sa_pa.sub_ya.sub_i_marc_short
sa_ra.sub_i_marc
sa_ta.sub_i_marc
sa_ta.sub_ra.sub_i_marc
sa_ta.sub_ra.sub_i_marc_short
sa_ta.sub_wa.sub_i_marc
sa_ta.sub_wa.sub_i_marc_short
sa_tsa.sub_i_marc
sa_wa.sub_i_marc
sha_i_marc
sha_ra.sub_i_marc
sha_wa.sub_i_marc
ta_i_marc
ta_ra.sub_i_marc
ta_wa.sub_i_marc
tha_i_marc
tha_ra.sub_i_marc
tsa_i_marc
tsa_wa.sub_i_marc
tsha_i_marc
tsha_wa.sub_i_marc
wa_i_marc
ya_i_marc
za_i_marc
za_la.sub_i_marc
za_la.sub_i_marc_short
za_wa.sub_i_marc
zha_i_marc
zha_wa.sub_i_marc
coverage definition end

inputcoverage definition begin
candrabindu_marc
coverage definition end

coverage	1,12
lookup end

